000000000000
000000000000
000000000000
000011100000
000000100000
000000100000
001111100000
001000000000
001000000000
001111100000
000000000000
000000000000
000000000000
